21 32
11111111111111111111111111111111
1pppppppp1ppppppp1ppppppp1ppppp1
1p11p111p1p11111p1p11111p1p111p1
1p11p111p1p11111p1p11111p1p111p1
1pppppppppppppppppppppppppppppp1
1p11p1p11111p1p11111p1p11111p1p1
1pppp1ppp1ppp1ppp1ppp1ppp1ppp1p1
1111p1p1p1p1p111p1p111p1p1p1p1p1
1111p1p1p1p1p1ppppppp1p1p1p1p1p1
1000ppppppppp1p11111ppppppppppp1
1M00F1111111p1HCIPB111p1111111p1
1000ppppppppp1p11111ppppppppppp1
1111p1p1p1p1p1ppppppp1p1p1p1p1p1
1111p1p1p1p1p111p1p111p1p1p1p1p1
1pppp1ppp1ppp1ppp1ppp1ppp1ppp1p1
1p11p1p11111p1p11111p1p11111p1p1
1pppppppppppppppppppppppppppppp1
1p11p111p1p11111p1p11111p1p111p1
1p11p111p1p11111p1p11111p1p111p1
1pppppppp1ppppppp1ppppppp1ppppp1
11111111111111111111111111111111
