20.20
11111111111111111111
10000000s00000000001
10000000000010000001
10000000000010000001
10111111111110000001
10000000000010000001
10000000000010000001
10000000000010000001
10FFFFFFF00010000001
10000000000010000001
10000M00000010000001
10000000000010000001
10000000000010000001
10000000000010000001
10000000000010000001
10000000000010000001
10000000000011101111
1000000000001IIIHII1
1000000000001IIIIII1
11111111111111111111