20.20
11111111111111111111
10000000s00000000001
10000000000010000001
1000M000000010000001
10111111111110000001
10000000000010000001
10000000000010000001
10000000000010000001
10000000000010000001
10000000000010000001
10000000000010000001
10000000000010000001
10000000000010000001
10000000000010000001
10000000000010000001
10000000000010000001
11111100000010000001
1BCIP100000010000001
100H0000000010000001
11111111111111111111