30 28 22 14 13 11 13 13 13 15 10 13
1111111111111111111111111111
1pppppppppppp11pppppppppppp1
1p1111p11111p11p11111p1111p1
1s1111p11111p11p11111p1111s1
1pppppppppppppppppppppppppp1
1p1111p11p11111111p11p1111p1
1p1111p11p11111111p11p1111p1
1pppppp11pppp11pppp11pppppp1
111111p11111011011111p111111
111111p11111011011111p111111
111111p11000000000011p111111
111111p11011100111011p111111
111111p11010000001011p111111
000000p00010000001000p000000
111111p11010000001011p111111
111111p11011111111011p111111
111111p11000000000011p111111
111111p11011111111011p111111
111111p11011111111011p111111
1pppppppppppp11pppppppppppp1
1p1111p11111p11p11111p1111p1
1p1111p11111p11p11111p1111p1
1ppp11ppppppp00ppppppp11pps1
111p11p11p11111111p11p11p111
111p11p11p11111111p11p11p111
1pppppp11pppp11pppp11pppppp1
1p1111111111p11p1111111111p1
1p1111111111p11p1111111111p1
1pppppppppppppppppppppppppp1
1111111111111111111111111111
