10 10
1111ss1111
1CI1pp1PB1
1111FF1111
1pppppppp1
sp111111ps
1p111111p1
1p111111p1
spppppMpps
1111pp1111
1111ss1111
