10 10
1111111111
1CIPB00001
1111111111
0spppppps0
1p111111p1
1F111111F1
1p111111p1
1p111111p1
1sppppppM1
1111111111
