27 21
111111111111111111111
1ppppppppp1ppppppppp1
1p111p111p1p111p111p1
1s101p101p1p101p101s1
1p111p111p1p111p111p1
1ppppppppppppppppppp1
1p111p1p11111p1p111p1
1p111p1p11111p1p111p1
1ppppp1ppp1ppp1ppppp1
11111p111010111p11111
00001p1000C0001p10000
00001p101101101p10000
11111p101000101p11111
00000p001IPB100p00000
11111p101111101p11111
00001p1000F0001p10000
00001p101111101p10000
11111p101111101p11111
1ppppppppp1ppppppppp1
1p111p111p1p111p111p1
1spp1pppppMppppp1pps1
111p1p1p11111p1p1p111
111p1p1p11111p1p1p111
1ppppp1ppp1ppp1ppppp1
1p1111111p1p1111111p1
1ppppppppppppppppppp1
111111111111111111111