10 10
0000000000
0000000000
0000F00000
0000000000
00p0000111
00p00001C1
00p00001H1
00s0000101
00M00001C1
0000000111
